{
  "172": "অ",
  "173": "আ",
  "174": "ই",
  "175": "ঈ",
  "176": "উ",
  "177": "ঊ",
  "178": "ঋ",
  "179": "এ",
  "180": "ঐ",
  "181": "ও",
  "182": "ঔ",
  "183": "ক",
  "184": "খ",
  "185": "গ",
  "186": "ঘ",
  "187": "ঙ",
  "188": "চ",
  "189": "ছ",
  "190": "জ",
  "191": "ঝ",
  "192": "ঞ",
  "193": "ট",
  "194": "ঠ",
  "195": "ড",
  "196": "ঢ",
  "197": "ণ",
  "198": "ত",
  "199": "থ",
  "200": "দ",
  "201": "ধ",
  "202": "ন",
  "203": "প",
  "204": "ফ",
  "205": "ব",
  "206": "ভ",
  "207": "ম",
  "208": "য",
  "209": "র",
  "210": "ল",
  "211": "শ",
  "212": "ষ",
  "213": "স",
  "214": "হ",
  "215": "ড়",
  "216": "ঢ়",
  "217": "য়",
  "218": "ৎ",
  "219": "ং",
  "220": "ঃ",
  "221": "ঁ"
}